He - Helium
Li - Lithium
Be - Beryllium
Ne - Neon
Na - Sodium
Mg - Magnesium
Al - Aluminum, Aluminium
Si - Silicon
Cl - Chlorine
Ar - Argon
Ca - Calcium
Sc - Scandium
Ti - Titanium
Cr - Chromium
Mn - Manganese
Fe - Iron
Co - Cobalt
Ni - Nickel
Cu - Copper
Zn - Zinc
Ga - Gallium
Ge - Germanium
As - Arsenic
Se - Selenium
Br - Bromine
Kr - Krypton
Rb - Rubidium
Sr - Strontium
Zr - Zirconium
Nb - Niobium
Mo - Molybdenum
Tc - Technetium
Ru - Ruthenium
Rh - Rhodium
Pd - Palladium
Ag - Silver
Cd - Cadmium
In - Indium
Sn - Tin
Sb - Antimony
Te - Tellurium
Xe - Xenon
Cs - Cesium
Ba - Barium
La - Lanthanum
Ce - Cerium
Pr - Praseodymium
Nd - Neodymium
Pm - Promethium
Sm - Samarium
Eu - Europium
Gd - Gadolinium
Tb - Terbium
Dy - Dysprosium
Ho - Holmium
Er - Erbium
Tm - Thulium
Yb - Ytterbium
Lu - Lutetium
Hf - Hafnium
Ta - Tantalum
Re - Rhenium
Os - Osmium
Ir - Iridium
Pt - Platinum
Au - Gold
Hg - Mercury
Tl - Thallium
Pb - Lead
Bi - Bismuth
Po - Polonium
At - Astatine
Rn - Radon
Fr - Francium
Ra - Radium
Ac - Actinium
Th - Thorium
Pa - Protactinium
Np - Neptunium
Pu - Plutonium
Am - Americium
Cm - Curium
Bk - Berkelium
Cf - Californium
Es - Einsteinium
Fm - Fermium
Md - Mendelevium
No - Nobelium
Lr - Lawrencium
Rf - Rutherfordium
Db - Dubnium
Sg - Seaborgium
Bh - Bohrium
Hs - Hassium
Mt - Meitnerium
Ds - Darmstadtium
Rg - Roentgenium
Cn - Copernicium
Nh - Nihonium
Fl - Flerovium
Mc - Moscovium
Lv - Livermorium
Ts - Tennessine
Og - Oganesson
